1111111111111111111111111111111111111111
1000000000000000000000000000000000000001
1000111100000000000220000000000000000001
1000000000002200000220000000000000000001
1000000000011110000220000000000000000001
1000000000000000000220000000000000000001
1000000000000000000220000000000000000001
10000000000000000002200000a0000000000001
100j0000k0000000000220000000000000000001
100j0000k0034000000220000000a00000000001
100000x000311400000220000000000000000001
101110x003111140022222211111111111111111
100000x031111114022222211111111111111111
156870x311111111422222211111111111111111
1zz0000000000000111111111111111111111111
1zz0000000000000111111111111111111111111
1111111111111111111111111111111111111111
