1111111111111111111111111111111111111111
1000000000000000000000000000000000000001
1000111100000000000220000000000000000001
1000000000002200000220000000000000000001
1000000000011110000220000000000000000001
1000000000000000000220000000000000000001
1000000000000000000220000000000000000001
10000000000000000002200000a0000000000001
1000000000000000000220000000000000000001
1000000000034000000220000000a00000000001
1000000000311400000220000000000000000001
1000000003111140022222211111111111111111
1000000031111114022222211111111111111111
1000000311111111422222211111111111111111
1000003111111111111111111111111111111111
1000031111111111111111111111111111111111
1111111111111111111111111111111111111111
